#####################
#ooooooooo#xoooooooo#
#o#######o###o#####o#
#o#ooooo#ooo#o#ooo#o#
#o#####o###o#o#o###o#
#ooooo#o#ooo#o#o#ooo#
#o###o#o###o###o###o#
#ooo#o#ooo#ooooo#o#o#
#o###o#o#o#o###o#o#o#
#o#ooo#o#o#o#ooo#o#o#
#o#####o#o#o#####o#o#
#ooooooo#o#ooooooo#o#
#o#o###o#o#######o#o#
#o#ooo#ooooooooo#o#o#
#o#####o#####o###o#o#
#o#ooT#ooooo#o#ooo#o#
#o#o###o###o###o###o#
#o#ooooo#o#o#ooo#ooo#
#o#######o###o###o#o#
#ooooooooooooooooo#o#
#####################
