###########
#oox#ooooo#
#o###o###o#
#o#o#o#o#o#
#o#o###o#o#
#o#ooooo#o#
#o#o###o#o#
#o#o#Goo#o#
#o#o#####o#
#ooooooooo#
###########
